h,h,h,h,h,h,h,h,h,h,h,h,h,h,h,h,h,h,
,h,h,h,h,h,h,h,h,h,h,h,h,h,h,h,h,h,h,
,h,h,c,h,h,h,h,h,h,h,h,h,h,h,h,h,h,h,
,h,h,h,h,h,h,h,h,h,h,h,h,h,h,h,h,h,h,
,h,h,h,h,h,h,h,h,h,h,h,h,h,h,h,h,h,h,
,h,h,h,h,h,h,h,h,h,h,h,h,h,h,h,h,h,h,
,h,h,h,h,h,h,h,h,h,h,h,h,h,h,h,h,h,h,
,h,h,h,h,h,h,h,h,h,h,h,h,h,h,h,h,h,h,
,h,h,h,h,h,h,h,h,h,h,h,h,h,h,h,h,h,h,
,h,h,c,h,h,h,h,h,c,h,h,h,h,h,h,h,h,h,
,h,h,h,h,h,h,h,h,h,h,h,h,h,h,h,h,h,h,
,h,h,h,h,h,h,h,h,h,h,h,h,h,h,h,h,h,h,
,h,h,h,h,h,h,h,h,h,h,h,h,h,h,h,h,h,h,
,h,h,h,h,h,h,h,h,h,h,h,h,h,h,h,h,h,h,
,h,h,h,h,h,h,h,h,h,h,h,h,h,h,h,h,h,h,
,h,h,h,h,h,h,h,h,h,h,h,h,h,h,h,h,h,h,
,h,h,h,h,h,h,h,h,h,h,h,h,h,h,h,h,h,h,